size:8

#####################
#                   #
#    x   x          o
#                   o
#       x           o
#                   #
#                   #
########ooo##########